######
#s####
#.##f#
#....#
######