#############
#s..#..#.##f#
#.##........#
#....########
#############