###############
#s..#..#.##...#
#.##........###
#....########f#
#.########....#
#....#####.####
###.######..###
###.####.##.###
###...........#
###############